###########
#        M#
# SM      #
#         #
#   A    M#
#M      MS#
###########
