%%%%%%%%%%%
%S        %
%M        %
%    A    %
%        A%
%       AS%
%%%%%%%%%%%
