###########
#         #
# S       #
#         #
# M       #
# A       #
###########
